####################
#..................#
#..................#
###########........#
#.........@........#
#...############...#
#.........#........#
#######...#...######
#.........#........#
#.H.############.H.#
#.........#........#
#######...#...######
#.........#........#
#.........@........#
####################