####################
#................#@#
#....#..#........#.#
######..#..#######.#
#.......#HH#.......#
#.#..#######.#####.#
#.#..#.......#HH...#
#.#..#.#####.#######
#.#..#.....#.......#
#.#HH#...#########.#
#.######........H#.#
#......#H#########.#
#.################.#
#@.................#
####################