...##############...
..##............####
.##..#######.......#
##.....@......#....#
#......########....#
###..###..###......#
..#..#H...###......#
.##.##.#....#.....##
#......#...##......#
#....###...........#
#....#....#..#.....#
#....#....#........#
.#.@....##....######
.#.................#
.###################